5555555555555555555555555555
5000000000000000000000000005
5000000000000000000000000005
5000000000000000000000000005
5000000444444444444440000005
5000000444444444444440000005
5000000444444444444440000005
5000011111100000011111100005
5000011111100000011111100005
5000000000000000000000000005
5044400000000000000000044405
5544400000011111100000044455
5544400000011901100000044455
5544400000011001100000044455
5544400000011111100000044455
5544400000000000000000044455
5044400000000000000000044405
5044400000000000000000044405
5044400000000000000000044405
5220011111100000011111100225
5220011111100000011111100225
5220000444444444444440000225
5220000444444444444440000225
5220000444444444444440000225
5220000000000000000000000225
5222220000000000000000222225
5222220000000000000000222225
5555555555555555555555555555
